111111111
10P0000E1
10000001
100C00001
111111111