111111111
1000000E1
1C00P0001
111111111