11111111111111111111111111
1000000000000000E110000001
10001000100101C00000000001
1000000CCCCC00000000110001
1P0010000000000C0000000001
11111111111111111111111111