1111111111111
100100000E101
1100001111101
1000100001101
1P10000100C01
1111111111111